111111111111111
100C00000000001
1E0110111011101
1000001C0001001
110C0C100010001
100000111100001
10000P000000001
111111111111111

65307	esc
65362	up
65361	left
65364	down
65363	right
32		space
