1111111
100C0P1
1E11101
1000001
110C011
1000001
1000000
1111111

65307	esc
65362	up
65361	left
65364	down
65363	right
32		space