1111111
100C0P1
1E11101
1000001
100C001
1000001
1111111
