1111111
100C001
1E01101
1000001
110C0C1
1000001
10000P1
1111111

65307	esc
65362	up
65361	left
65364	down
65363	right
32		space
