111111111111111111111111111111111111111
10000000C000000000000000000000000000001
1E0110111011000000000000000000000000101
100000100001000000000000000000000000001
1100001000100CCCCCCCCCCCCCC000000000001
110000100010000000000000000000000000001
110000100010000000000000000000000000001
110000100010000000000000000000000000001
110000100010000000000000000000000000001
110000100010000000000000000000000000001
110000100010000000000000000000000000001
110000100010000000000000000000000000001
100000111100000000000000000000000000001
10000P000000000000000000000000000000001
110000100010000000000000000000000000001
110000100010000000000000000000000000001
110000100010000000000000000000000000001
110000100010000000000000000000000000001
100000111100000000000000000000000000001
100000000000000000000000000000000000001
100000000000000000000000000000000000001
110000100010000000000000000000000000001
110000100010000000000000000000000000001
100000111100000000000000000000000000001
100000000000000000000000000000000000001
100000000000000000000000000000000000001
110000100010000000000000000000000000001
110000100010000000000000000000000000001
100000111100000000000000000000000000001
100000000000000000000000000000000000001
100000000000000000000000000000000000001
110000100010000000000000000000000000001
110000100010000000000000000000000000001
100000111100000000000000000000000000001
100000000000000000000000000000000000001
100000000000000000000000000000000000001
110000100010000000000000000000000000001
110000100010000000000000000000000000001
100000111100000000000000000000000000001
100000000000000000000000000000000000001
100000000000000000000000000000000000001
110000100010000000000000000000000000001
110000100010000000000000000000000000001
100000111100000000000000000000000000001
100000000000000000000000000000000000001
100000000000000000000000000000000000001
110000100010000000000000000000000000001
110000100010000000000000000000000000001
100000111100000000000000000000000000001
100000000000000000000000000000000000001
100000000000000000000000000000000000001
110000100010000000000000000000000000001
110000100010000000000000000000000000001
100000111100000000000000000000000000001
100000000000000000000000000000000000001
100000000000000000000000000000000000001
110000100010000000000000000000000000001
110000100010000000000000000000000000001
100000111100000000000000000000000000001
100000000000000000000000000000000000001
100000000000000000000000000000000000001
110000100010000000000000000000000000001
110000100010000000000000000000000000001
100000111100000000000000000000000000001
100000000000000000000000000000000000001
100000000000000000000000000000000000001
110000100010000000000000000000000000001
110000100010000000000000000000000000001
100000111100000000000000000000000000001
100000000000000000000000000000000000001
100000000000000000000000000000000000001
110000100010000000000000000000000000001
110000100010000000000000000000000000001
100000111100000000000000000000000000001
100000000000000000000000000000000000001
100000000000000000000000000000000000001
110000100010000000000000000000000000001
110000100010000000000000000000000000001
100000111100000000000000000000000000001
100000000000000000000000000000000000001
100000000000000000000000000000000000001
110000100010000000000000000000000000001
110000100010000000000000000000000000001
100000111100000000000000000000000000001
100000000000000000000000000000000000001
100000000000000000000000000000000000001
110000100010000000000000000000000000001
110000100010000000000000000000000000001
100000111100000000000000000000000000001
100000000000000000000000000000000000001
100000000000000000000000000000000000001
110000100010000000000000000000000000001
110000100010000000000000000000000000001
100000111100000000000000000000000000001
100000000000000000000000000000000000001
100000000000000000000000000000000000001
110000100010000000000000000000000000001
110000100010000000000000000000000000001
100000111100000000000000000000000000001
100000000000000000000000000000000000001
100000000000000000000000000000000000001
110000100010000000000000000000000000001
110000100010000000000000000000000000001
100000111100000000000000000000000000001
100000000000000000000000000000000000001
100000000000000000000000000000000000011
111111111111111111111111111111111111111