111111111111111
10000000C000001
1E0110111011101
100000100001001
110000100010001
100000111100001
10000P000000001
111111111111111
111111111111111