1111111
100C001
1E11101
10000P1
110C011
1000001
1000000
1111111

65307	esc
65362	up
65361	left
65364	down
65363	right
32		space